F 50,10,15
C 66,22,200

11111
10001
10W01
10001
11111
